0000101100
2211002020
0000002000
2022000020
0020021010
0020020020
0020120122
0000000000

