0000000000
2211022110
0000022110
2222000110
0000021110
0220220020
0020120122
0000000000

